[
    {
        "basePoints": 1,
        "thresholds": [
            1,
            2,
            3
        ],
        "name": "Warm-up",
        "data": [
            "############",
            "#P        X#",
            "############"
        ]
    },
    {
        "basePoints": 2,
        "thresholds": [
            3,
            4,
            5
        ],
        "data": [
            "################",
            "#  # X         #",
            "#              #",
            "#  P           #",
            "################"
        ]
    },
    {
        "basePoints": 2,
        "thresholds": [
            4,
            6,
            10
        ],
        "data": [
            "#######X########",
            "#   #       #  #",
            "#       # #    #",
            "#  #           #",
            "##             #",
            "#      #       #",
            "#  #   P   #  ##",
            "################"
        ]
    },
    {
        "basePoints": 7,
        "thresholds": [
            8,
            9,
            11
        ],
        "data": [
            "##############",
            "# #    #    P#",
            "#    #     # #",
            "#     #      #",
            "#            #",
            "#        #   #",
            "# #       #  #",
            "#      #     #",
            "#  #         #",
            "##        #  #",
            "#      #     #",
            "#   #        #",
            "#   #     #  #",
            "######X#######"
        ]
    },
    {
        "basePoints": 8,
        "thresholds": [
            7,
            9,
            13
        ],
        "data": [
            "##############",
            "#          # #",
            "#  #  #      X",
            "#           P#",
            "# ##     #   #",
            "#    #       #",
            "##          ##",
            "#   #        #",
            "#     #      #",
            "# # #   #    #",
            "#    #    #  #",
            "#     ####   #",
            "##          ##",
            "##############"
        ]
    },
    {
        "basePoints": 5,
        "thresholds": [
            9,
            11,
            15
        ],
        "data": [
            "############",
            "#O.........X",
            "##    ### ##",
            "#.........O#",
            "#.#   #   ##",
            "#..      # #",
            "##........ #",
            "#.........##",
            "#.  # #  # #",
            "#......    #",
            "#  #  P    #",
            "############"
        ]
    },
    {
        "name": "The Line",
        "basePoints": 12,
        "thresholds": [
            16,
            17,
            25
        ],
        "data": [
            "####################",
            "#             # #  #",
            "#  #   ##    # #   #",
            "# #     # #  #O    #",
            "#  ##        #     #",
            "#      #    #      #",
            "##    #            #",
            "#   #         ##   #",
            "#  #     #         #",
            "#                  #",
            "#  #    #        # #",
            "#   # #        #   #",
            "##     #        #  #",
            "#     ## #  #      #",
            "#    #       # #   #",
            "#             #    #",
            "# #P   #          ##",
            "# ##################",
            "#O                X#",
            "####################"
        ]
    },
    {
        "name": "Around The World",
        "basePoints": 17,
        "thresholds": [
            29,
            30,
            40
        ],
        "data": [
            "####################",
            "#          ##      #",
            "##     #   #    #  #",
            "#  O# # #     # #  #",
            "#  #         #     #",
            "# #    #    #    # #",
            "#   #   #  #       #",
            "#    #  #### #     #",
            "#      ##  #  #    #",
            "# #     #OX#P    # #",
            "#  ###  #  ##   #  #",
            "#     # ####       #",
            "# #  #  ##   #    ##",
            "#  #   #    #   #  #",
            "#    #             #",
            "#  #               #",
            "# #    #     # #   #",
            "#   #  #    # #    #",
            "#  ###   #       # #",
            "####################"
        ]
    },
    {
        "name": "Roman Rooms",
        "basePoints": 18,
        "thresholds": [
            39,
            44,
            50
        ],
        "data": [
            "####################",
            "# #      #   ##   P#",
            "#    ##      #     #",
            "#  # ###  #  #    ##",
            "#     #    # # #   #",
            "#     #      #   # #",
            "###  ## ########## #",
            "#     #      #O    #",
            "##    ###      #   #",
            "#   ###         #  #",
            "##    #    #     # #",
            "# #   #            #",
            "#O    #  #        ##",
            "###  ####### # #####",
            "#     #   #  #    X#",
            "##   ##    # #    ##",
            "#   # #      # #   #",
            "#     ##    ##  #  #",
            "# #          ##    #",
            "####################"
        ]
    },
    {
        "basePoints": 20,
        "thresholds": [
            26,
            28,
            30
        ],
        "data": [
            "####################",
            "#   # # #         ##",
            "#      ###  #    O #",
            "#       #   #  #   #",
            "##  # #  # #       #",
            "#       #    #   ###",
            "#      # #  #      #",
            "##      #       ## #",
            "#    ### ### ## #  #",
            "#    #P #          #",
            "# O               ##",
            "#       #          #",
            "#        # #       #",
            "#   #   #   #    # #",
            "#    #   #  #  #   #",
            "#  #    #      ## ##",
            "#     #  #    ##   #",
            "#     # # #        X",
            "# #  ##    #    #  #",
            "####################"
        ]
    },
    {
        "basePoints": 23,
        "thresholds": [
            16,
            19,
            29
        ],
        "data": [
            "####################",
            "#    #  #      #   #",
            "#   #    #   #     #",
            "# #      ##       ##",
            "#       ##   #     #",
            "#  #      #        #",
            "#     #   ##  # ## #",
            "#         #        #",
            "#  #   # #    #    #",
            "##  #   P#X#O   # ##",
            "#   #    #   ##    #",
            "#      ### #     # #",
            "#  #     #         #",
            "###      #         #",
            "#   # #  ###  #   ##",
            "#    #   # #       #",
            "# # #       #     ##",
            "#  #  # ##     #   #",
            "#O       #   #   # #",
            "####################"
        ]
    },
    {
        "thresholds": [
            18,
            19,
            25
        ],
        "basePoints": 27,
        "name": "<no name>",
        "data": [
            "#############       ",
            "#    #     ##       ",
            "#           #       ",
            "#  # #  #   #       ",
            "#  #   #    X       ",
            "#      #  # ########",
            "#   #       #      #",
            "# #        #     # #",
            "#   #         #    #",
            "#     #            #",
            "#        ##   #    #",
            "#       #      #   #",
            "#   #              #",
            "#          ##     ##",
            "##     #      #    #",
            "#    #             #",
            "#           #     ##",
            "#        #         #",
            "##           # ##  #",
            "#     # #  #       #",
            "#           # #P # #",
            "#       #          #",
            "#    #        #    #",
            "####################"
        ]
    },
    {
        "basePoints": 7,
        "thresholds": [
            24,
            29,
            36
        ],
        "data": [
            "##############",
            "#$#  $ #    P#",
            "#    #     # #",
            "#     #      #",
            "#     $      #",
            "#        #   #",
            "# # $     #  #",
            "#      #     #",
            "#  #       $ #",
            "## $      #  #",
            "#      #     #",
            "#   #        #",
            "#$  #     #  #",
            "######X#######"
        ]
    },
    {
        "name": "Be Careful",
        "basePoints": 10,
        "thresholds": [
            23,
            34,
            50
        ],
        "data": [
            "#########X##########",
            "##    $# $        $#",
            "#$      O          #",
            "#          #       #",
            "#                 ##",
            "#                  #",
            "#                  #",
            "#                  #",
            "#   #              #",
            "#     # #          #",
            "#           #      #",
            "#      #      $    #",
            "#                 ##",
            "#  #          $   O#",
            "#      $ #         #",
            "#       #     #    #",
            "# #                #",
            "#                  #",
            "#        P         #",
            "####################"
        ]
    }
]